0,0,0,0,0,0,0,0,0,0,0
0,3,1,1,1,0,0,0,0,0,0
0,1,1,2,1,1,1,1,0,0,0
0,1,2,2,6,6,6,1,1,1,0
0,1,1,6,4,2,2,1,0,7,0
0,0,5,6,2,6,6,1,0,0,0
0,9,1,6,2,2,2,1,8,0,0
0,0,0,0,0,0,0,0,0,0,0
